0,1,1,1,1,1,1,1,1,1,1,1,1,1,2
8,9,9,9,9,9,9,9,9,9,9,9,9,9,10
16,81,81,81,81,81,81,81,81,81,81,81,81,81,18
64,64,64,64,64,64,64,64,64,64,64,64,64,64,64
64,64,64,64,64,64,64,64,64,64,64,64,64,64,64
64,64,64,64,64,64,101,102,103,64,64,64,64,64,64
64,64,64,64,64,64,109,110,111,64,64,64,64,64,64
64,64,64,64,64,64,117,118,119,64,64,64,64,64,64
64,64,64,64,64,64,64,64,64,64,64,64,64,64,64
64,64,64,64,64,64,64,64,64,64,64,64,64,64,64
64,64,64,64,64,64,64,64,64,64,64,64,64,64,64